0, 0, 35, 56, 53, 56, 66, 45, 45, 68, 56, 53, 56, 34, 0, 0
,
0, 0, 35, 56, 54, 56, 66, 45, 45, 68, 56, 54, 56, 34, 0, 0
,
0, 0, 35, 57, 55, 57, 67, 25, 24, 69, 57, 55, 57, 34, 0, 0
,
0, 0, 35, 25, 20, 20, 20, 26, 27, 20, 20, 20, 24, 34, 0, 0
,
0, 0, 35, 18, 16, 16, 16, 16, 16, 16, 16, 16, 19, 34, 0, 0
,
0, 0, 35, 18, 16, 16, 16, 58, 61, 16, 16, 16, 19, 34, 0, 0
,
0, 0, 35, 18, 16, 16, 16, 59, 62, 16, 16, 16, 19, 34, 0, 0
,
0, 0, 35, 18, 16, 16, 16, 60, 63, 16, 16, 16, 19, 34, 0, 0
,
0, 0, 35, 18, 16, 16, 16, 16, 16, 16, 16, 16, 19, 34, 0, 0
,
0, 0, 35, 18, 16, 46, 16, 16, 16, 16, 46, 16, 19, 34, 0, 0
,
0, 0, 35, 18, 16, 47, 16, 16, 16, 16, 47, 16, 19, 34, 0, 0
,
0, 0, 35, 18, 16, 16, 16, 16, 16, 16, 16, 16, 19, 34, 0, 0
,
0, 0, 35, 22, 21, 21, 21, 21, 21, 21, 21, 21, 23, 34, 0, 0
,
0, 0, 42, 33, 33, 33, 38, 17, 17, 37, 33, 33, 33, 41, 0, 0
,
0, 0, 0, 0, 0, 0, 35, 17, 17, 34, 0, 0, 0, 0, 0, 0
,
0, 0, 0, 0, 0, 0, 35, 17, 17, 34, 0, 0, 0, 0, 0, 0
,
0, 0, 0, 0, 0, 0, 35, 17, 17, 34, 0, 0, 0, 0, 0, 0
,
0, 0, 0, 0, 0, 0, 35, 17, 17, 34, 0, 0, 0, 0, 0, 0
,
0, 0, 0, 0, 0, 0, 35, 17, 17, 34, 0, 0, 0, 0, 0, 0
,
0, 0, 0, 0, 0, 0, 35, 17, 17, 34, 0, 0, 0, 0, 0, 0
,
0, 0, 0, 0, 0, 0, 35, 17, 17, 34, 0, 0, 0, 0, 0, 0
,
0, 0, 0, 0, 0, 0, 35, 17, 17, 34, 0, 0, 0, 0, 0, 0
,
0, 0, 0, 0, 0, 0, 35, 17, 17, 34, 0, 0, 0, 0, 0, 0
,
0, 0, 0, 0, 0, 0, 35, 17, 17, 34, 0, 0, 0, 0, 0, 0
,
0, 0, 0, 0, 0, 0, 35, 17, 17, 34, 0, 0, 0, 0, 0, 0
,
0, 0, 0, 0, 0, 0, 35, 17, 17, 34, 0, 0, 0, 0, 0, 0
,
0, 0, 0, 0, 0, 0, 35, 17, 17, 34, 0, 0, 0, 0, 0, 0
,
0, 0, 0, 0, 0, 0, 35, 17, 17, 34, 0, 0, 0, 0, 0, 0
,
0, 0, 0, 0, 0, 0, 35, 17, 17, 34, 0, 0, 0, 0, 0, 0
,
0, 0, 0, 0, 0, 0, 35, 17, 17, 34, 0, 0, 0, 0, 0, 0
,
0, 0, 0, 0, 0, 0, 35, 17, 17, 34, 0, 0, 0, 0, 0, 0
,
0, 0, 0, 0, 0, 0, 35, 17, 17, 34, 0, 0, 0, 0, 0, 0
,
0, 0, 0, 0, 0, 0, 35, 17, 17, 34, 0, 0, 0, 0, 0, 0
,
0, 0, 0, 0, 0, 0, 35, 17, 17, 34, 0, 0, 0, 0, 0, 0
,
0, 0, 0, 0, 0, 0, 42, 33, 33, 41, 0, 0, 0, 0, 0, 0
