0, 43, 36, 36, 36, 36, 36, 36, 36, 36, 36, 36, 36, 36, 44, 0
,
0, 35, 50, 50, 50, 50, 66, 45, 45, 68, 50, 50, 50, 50, 34, 0
,
0, 35, 50, 50, 50, 50, 66, 45, 45, 68, 50, 50, 50, 50, 34, 0
,
0, 35, 50, 50, 50, 50, 67, 17, 17, 69, 50, 50, 50, 50, 34, 0
,
0, 35, 25, 20, 20, 20, 24, 17, 17, 25, 20, 20, 20, 24, 34, 0
,
0, 35, 18, 84, 84, 84, 27, 20, 20, 26, 84, 84, 84, 19, 34, 0
,
0, 35, 18, 84, 84, 84, 84, 84, 84, 84, 84, 84, 84, 19, 34, 0
,
0, 35, 18, 84, 84, 84, 84, 84, 84, 84, 84, 84, 84, 19, 34, 0
,
0, 35, 18, 84, 84, 84, 84, 84, 84, 84, 84, 84, 84, 19, 34, 0
,
0, 35, 18, 84, 84, 84, 28, 21, 21, 29, 84, 84, 84, 19, 34, 0
,
0, 35, 22, 21, 21, 21, 23, 17, 17, 22, 21, 21, 21, 23, 34, 0
,
0, 42, 33, 33, 33, 33, 38, 17, 17, 37, 33, 33, 33, 33, 41, 0
,
0, 0, 0, 0, 0, 0, 42, 33, 33, 41, 0, 0, 0, 0, 0, 0
,
0, 0, 0, 0, 0, 0, 0, 0, 0, 0, 0, 0, 0, 0, 0, 0
