0, 35, 49, 51, 49, 49, 51, 49, 49, 51, 49, 49, 51, 49, 49, 34, 
0, 0, 0, 0, 35, 51, 49, 66, 45, 45, 68, 49, 51, 34,
0, 35, 48, 50, 48, 48, 50, 48, 48, 50, 48, 48, 50, 48, 48, 34, 
0, 0, 0, 0, 35, 50, 48, 66, 45, 45, 68, 48, 50, 34,
0, 35, 49, 52, 49, 49, 52, 49, 49, 52, 49, 49, 52, 49, 49, 34, 
0, 0, 0, 0, 35, 52, 49, 67, 17, 17, 69, 49, 52, 34,
0, 35, 30, 32, 32, 32, 32, 32, 32, 32, 32, 32, 32, 32, 32, 39, 
36, 36, 36, 36, 40, 25, 24, 17, 17, 17, 17, 25, 24, 34,
0, 35, 0, 25, 24, 0, 0, 0, 0, 0, 0, 0, 0, 0, 0, 51, 
49, 49, 49, 49, 51, 18, 19, 17, 17, 17, 17, 18, 19, 34,
0, 35, 0, 22, 23, 0, 0, 0, 0, 0, 0, 0, 0, 15, 15, 50, 
48, 48, 48, 48, 50, 18, 27, 20, 20, 20, 20, 26, 19, 34,
0, 35, 0, 30, 31, 0, 0, 0, 0, 0, 0, 0, 0, 7, 7, 52, 
49, 49, 49, 49, 52, 18, 46, 81, 81, 81, 81, 81, 19, 34,
0, 35, 0, 0, 0, 0, 0, 0, 0, 0, 0, 0, 0, 7, 7, 3, 
3, 8, 9, 3, 3, 18, 47, 81, 81, 81, 81, 81, 19, 34,
0, 35, 3, 3, 0, 0, 25, 20, 24, 0, 0, 0, 0, 14, 14, 3, 
3, 8, 9, 3, 3, 18, 81, 81, 81, 81, 81, 46, 19, 34,
0, 35, 3, 3, 0, 0, 18, 81, 19, 0, 0, 0, 0, 3, 3, 11, 
10, 3, 3, 13, 13, 18, 81, 81, 81, 81, 81, 47, 19, 34,
0, 35, 3, 3, 0, 0, 22, 21, 23, 0, 0, 0, 0, 3, 3, 11, 
10, 3, 3, 12, 12, 22, 21, 21, 21, 21, 21, 21, 23, 34,
0, 35, 30, 31, 0, 0, 30, 32, 31, 0, 0, 0, 37, 33, 33, 33, 
33, 33, 33, 33, 33, 33, 33, 33, 33, 33, 33, 33, 33, 41,
0, 35, 0, 0, 0, 0, 0, 0, 0, 0, 0, 0, 34, 0, 0, 0, 
0, 0, 0, 0, 0, 0, 0, 0, 0, 0, 0, 0, 0, 0,
0, 35, 0, 25, 20, 20, 24, 0, 0, 0, 0, 0, 39, 36, 36, 36, 
36, 36, 36, 36, 36, 36, 36, 36, 36, 36, 36, 36, 44, 0,
0, 35, 0, 22, 21, 21, 23, 0, 0, 0, 0, 0, 49, 49, 51, 49, 
49, 51, 49, 49, 51, 49, 49, 51, 49, 49, 51, 49, 34, 0,
0, 35, 0, 30, 32, 32, 31, 0, 0, 0, 0, 0, 48, 48, 50, 48, 
48, 50, 48, 48, 50, 48, 48, 50, 48, 48, 50, 48, 34, 0,
0, 35, 0, 0, 0, 0, 0, 0, 0, 0, 0, 0, 49, 49, 52, 49, 
49, 52, 49, 49, 52, 49, 49, 52, 49, 49, 52, 49, 34, 0,
0, 35, 0, 0, 25, 20, 20, 24, 0, 0, 0, 0, 3, 3, 3, 3, 
25, 20, 20, 24, 46, 46, 25, 24, 3, 3, 25, 24, 34, 0,
0, 35, 0, 0, 18, 81, 81, 19, 0, 0, 0, 0, 3, 3, 3, 3, 
22, 21, 21, 23, 47, 47, 18, 19, 3, 3, 18, 19, 34, 0,
0, 35, 0, 0, 18, 81, 81, 19, 0, 0, 0, 0, 25, 24, 30, 31, 
8, 9, 11, 10, 3, 3, 18, 19, 46, 46, 18, 19, 34, 0,
0, 35, 0, 0, 22, 21, 21, 23, 0, 0, 0, 0, 18, 19, 0, 0, 
8, 9, 11, 10, 3, 3, 18, 19, 47, 47, 18, 19, 34, 0,
0, 35, 0, 0, 30, 32, 32, 31, 0, 0, 0, 0, 18, 19, 3, 3, 
25, 20, 20, 24, 46, 46, 18, 19, 3, 3, 18, 19, 34, 0,
0, 35, 0, 0, 0, 0, 0, 0, 0, 0, 0, 0, 22, 23, 3, 3, 
18, 28, 21, 23, 47, 47, 18, 19, 3, 3, 22, 23, 34, 0,
0, 35, 0, 0, 0, 0, 0, 0, 0, 0, 0, 0, 3, 3, 30, 31, 
18, 19, 46, 46, 3, 3, 18, 19, 46, 46, 3, 3, 34, 0,
0, 35, 0, 0, 0, 0, 0, 0, 0, 0, 0, 0, 3, 3, 0, 0, 
22, 23, 47, 47, 3, 3, 22, 23, 47, 47, 3, 3, 34, 0,
0, 42, 33, 33, 33, 33, 33, 33, 33, 33, 33, 33, 33, 33, 33, 38, 
3, 3, 3, 3, 46, 46, 3, 3, 15, 15, 3, 3, 34, 0,
0, 0, 0, 0, 0, 0, 0, 0, 0, 0, 0, 0, 0, 0, 0, 35, 
3, 3, 3, 3, 47, 47, 3, 3, 7, 7, 3, 3, 34, 0,
0, 0, 0, 0, 0, 0, 0, 0, 0, 0, 0, 0, 0, 0, 0, 42, 
33, 38, 3, 3, 25, 20, 20, 24, 7, 7, 25, 24, 34, 0,
0, 0, 0, 0, 0, 0, 0, 0, 0, 0, 0, 0, 0, 0, 0, 0, 
0, 35, 3, 3, 22, 21, 29, 19, 7, 7, 18, 19, 34, 0,
0, 0, 0, 0, 0, 0, 0, 0, 0, 0, 0, 0, 0, 0, 0, 0, 
0, 42, 33, 38, 15, 15, 18, 19, 14, 14, 22, 23, 34, 0,
0, 0, 0, 0, 0, 0, 0, 0, 0, 0, 0, 0, 0, 0, 0, 0, 
0, 0, 0, 35, 7, 7, 18, 19, 3, 3, 46, 46, 34, 0,
0, 0, 0, 0, 0, 0, 0, 0, 0, 0, 0, 0, 0, 0, 0, 0, 
0, 0, 0, 35, 14, 14, 18, 19, 3, 3, 47, 47, 34, 0,
0, 0, 0, 0, 0, 0, 0, 0, 0, 0, 0, 0, 0, 0, 0, 0, 
0, 0, 0, 35, 3, 3, 18, 27, 20, 20, 20, 24, 34, 0,
43, 36, 36, 36, 36, 36, 36, 36, 36, 36, 36, 36, 36, 36, 36, 36, 
36, 36, 36, 40, 3, 3, 22, 21, 21, 21, 21, 23, 34, 0,
35, 51, 49, 49, 51, 49, 49, 51, 49, 49, 51, 49, 49, 51, 49, 49, 
51, 49, 49, 51, 30, 32, 32, 32, 32, 32, 31, 37, 41, 0,
35, 50, 48, 48, 50, 48, 48, 50, 48, 48, 50, 48, 48, 50, 48, 48, 
50, 48, 48, 50, 0, 0, 0, 0, 0, 0, 0, 34, 0, 0,
35, 52, 49, 49, 52, 49, 49, 52, 49, 49, 52, 49, 49, 52, 49, 49, 
52, 49, 49, 52, 0, 0, 0, 0, 0, 0, 0, 34, 0, 0,
35, 25, 20, 20, 24, 3, 3, 11, 10, 30, 32, 32, 32, 31, 25, 24, 
30, 32, 32, 31, 3, 3, 3, 0, 0, 0, 0, 34, 0, 0,
35, 18, 81, 81, 19, 3, 3, 11, 10, 0, 0, 0, 0, 0, 18, 19, 
0, 0, 0, 0, 3, 3, 3, 0, 0, 0, 0, 34, 0, 0,
35, 18, 81, 81, 19, 3, 3, 11, 10, 0, 0, 0, 0, 0, 18, 19, 
0, 0, 0, 0, 3, 3, 3, 0, 0, 0, 0, 34, 0, 0,
35, 18, 81, 81, 19, 3, 3, 11, 10, 0, 0, 0, 0, 0, 22, 23, 
0, 0, 0, 0, 30, 32, 31, 0, 0, 0, 0, 34, 0, 0,
35, 18, 81, 81, 19, 3, 3, 11, 10, 0, 0, 0, 0, 0, 37, 38, 
0, 0, 0, 0, 0, 0, 0, 0, 0, 0, 0, 34, 0, 0,
35, 18, 81, 81, 19, 3, 3, 11, 10, 0, 0, 0, 0, 0, 34, 35, 
0, 0, 0, 0, 0, 0, 0, 0, 0, 0, 0, 34, 0, 0,
35, 18, 81, 81, 27, 20, 20, 20, 24, 37, 33, 33, 33, 33, 41, 42, 
33, 33, 33, 33, 33, 33, 33, 33, 33, 33, 33, 41, 0, 0,
35, 18, 46, 81, 81, 81, 81, 46, 19, 34, 0, 0, 0, 0, 0, 0, 
0, 0, 0, 0, 0, 0, 0, 0, 0, 0, 0, 0, 0, 0,
35, 18, 47, 81, 81, 81, 81, 47, 19, 34, 0, 0, 0, 0, 0, 0, 
0, 0, 0, 0, 0, 0, 0, 0, 0, 0, 0, 0, 0, 0,
35, 22, 21, 29, 81, 81, 28, 21, 23, 34, 0, 0, 0, 0, 0, 0, 
0, 0, 0, 0, 0, 0, 0, 0, 0, 0, 0, 0, 0, 0,
42, 33, 38, 18, 81, 81, 19, 37, 33, 41, 0, 0, 0, 0, 0, 0, 
0, 0, 0, 0, 0, 0, 0, 0, 0, 0, 0, 0, 0, 0,
0, 0, 35, 18, 81, 81, 19, 34, 0, 0, 0, 0, 0, 0, 0, 0, 
0, 0, 0, 0, 0, 0, 0, 0, 0, 0, 0, 0, 0, 0,
0, 0, 35, 22, 21, 21, 23, 34, 0, 0, 0, 0, 0, 0, 0, 0, 
0, 0, 0, 0, 0, 0, 0, 0, 0, 0, 0, 0, 0, 0,
0, 0, 42, 33, 33, 33, 33, 41, 0, 0, 0, 0, 0, 0, 0, 0, 
0, 0, 0, 0, 0, 0, 0, 0, 0, 0, 0, 0, 0, 0