0, 35, 49, 49, 49, 49, 66, 45, 45, 68, 49, 49, 49, 49, 34, 0
,
0, 35, 48, 48, 48, 48, 66, 45, 45, 68, 48, 48, 48, 48, 34, 0
,
0, 35, 49, 49, 49, 49, 67, 25, 24, 69, 49, 49, 49, 49, 34, 0
,
0, 35, 25, 20, 20, 20, 20, 26, 27, 20, 20, 20, 20, 24, 34, 0
,
0, 35, 18, 82, 82, 82, 82, 82, 82, 82, 82, 82, 82, 19, 34, 0
,
0, 35, 18, 82, 82, 82, 82, 82, 82, 82, 82, 82, 82, 19, 34, 0
,
0, 35, 18, 82, 82, 82, 82, 82, 82, 82, 82, 82, 82, 19, 34, 0
,
0, 35, 18, 82, 82, 82, 82, 82, 82, 82, 82, 82, 82, 19, 34, 0
,
0, 35, 18, 82, 82, 82, 82, 82, 82, 82, 82, 82, 82, 19, 34, 0
,
0, 35, 18, 82, 82, 82, 82, 82, 82, 82, 82, 82, 82, 19, 34, 0
,
0, 35, 18, 82, 82, 82, 82, 82, 82, 82, 82, 82, 82, 19, 34, 0
,
0, 35, 18, 82, 82, 82, 82, 82, 82, 82, 82, 82, 82, 19, 39, 44
,
0, 35, 18, 82, 82, 82, 82, 82, 82, 82, 82, 82, 82, 27, 24, 34
,
0, 35, 18, 82, 82, 82, 82, 82, 82, 82, 82, 82, 82, 82, 19, 34
,
0, 35, 18, 82, 82, 82, 82, 82, 82, 82, 82, 82, 82, 82, 19, 34
,
0, 35, 22, 21, 21, 21, 21, 21, 21, 29, 82, 82, 82, 82, 19, 34
,
0, 42, 33, 33, 33, 33, 33, 33, 38, 18, 82, 82, 82, 82, 19, 34
,
0, 0, 0, 0, 0, 0, 0, 0, 35, 94, 93, 93, 93, 93, 95, 34
,
0, 0, 0, 0, 0, 0, 0, 0, 35, 18, 82, 82, 82, 82, 19, 34
,
0, 0, 0, 0, 0, 0, 0, 0, 35, 18, 82, 82, 82, 82, 19, 34
,
0, 0, 0, 0, 0, 0, 0, 0, 35, 18, 82, 82, 82, 82, 19, 34
,
0, 0, 0, 0, 0, 0, 0, 0, 35, 94, 93, 93, 93, 93, 95, 34
,
0, 0, 0, 0, 0, 0, 0, 0, 35, 18, 82, 82, 82, 82, 19, 34
,
0, 0, 0, 0, 0, 0, 0, 0, 35, 18, 82, 82, 82, 82, 19, 34
,
0, 0, 0, 0, 0, 0, 0, 0, 35, 18, 82, 82, 82, 82, 19, 34
,
0, 0, 0, 0, 0, 0, 0, 0, 35, 94, 93, 93, 93, 93, 95, 34
,
0, 43, 36, 36, 36, 36, 36, 36, 40, 18, 82, 82, 82, 82, 19, 34
,
0, 35, 25, 20, 20, 20, 20, 20, 20, 26, 82, 82, 82, 82, 19, 34
,
0, 35, 18, 82, 82, 82, 82, 82, 82, 82, 82, 82, 82, 82, 19, 34
,
0, 35, 18, 82, 82, 82, 82, 82, 82, 82, 82, 82, 82, 82, 19, 34
,
0, 35, 18, 82, 82, 82, 82, 82, 82, 82, 82, 82, 82, 82, 19, 34
,
0, 35, 18, 82, 82, 82, 82, 28, 21, 21, 21, 21, 21, 21, 23, 34
,
0, 35, 18, 82, 82, 82, 82, 19, 37, 33, 33, 33, 33, 33, 33, 41
,
0, 35, 18, 28, 21, 21, 29, 19, 34, 0, 0, 0, 0, 0, 0, 0
,
0, 35, 18, 19, 30, 31, 18, 19, 34, 0, 0, 0, 0, 0, 0, 0
,
0, 35, 18, 19, 0, 0, 18, 19, 34, 0, 0, 0, 0, 0, 0, 0
,
0, 35, 18, 27, 20, 20, 26, 19, 34, 0, 0, 0, 0, 0, 0, 0
,
0, 35, 18, 82, 82, 82, 82, 19, 34, 0, 0, 0, 0, 0, 0, 0
,
0, 35, 18, 82, 82, 82, 82, 19, 34, 0, 0, 0, 0, 0, 0, 0
,
0, 35, 18, 82, 82, 82, 82, 19, 34, 0, 0, 0, 0, 0, 0, 0
,
0, 35, 18, 82, 82, 82, 82, 19, 34, 0, 0, 0, 0, 0, 0, 0
,
0, 35, 18, 82, 82, 82, 82, 19, 34, 0, 0, 0, 0, 0, 0, 0
,
0, 35, 18, 82, 82, 82, 82, 19, 34, 0, 0, 0, 0, 0, 0, 0
,
0, 35, 18, 82, 82, 82, 82, 19, 34, 0, 0, 0, 0, 0, 0, 0
,
0, 35, 18, 82, 82, 82, 82, 19, 34, 0, 0, 0, 0, 0, 0, 0
,
0, 35, 18, 28, 21, 21, 29, 19, 34, 0, 0, 0, 0, 0, 0, 0
,
0, 35, 18, 19, 30, 31, 18, 19, 34, 0, 0, 0, 0, 0, 0, 0
,
0, 35, 18, 19, 0, 0, 18, 19, 34, 0, 0, 0, 0, 0, 0, 0
,
0, 35, 18, 27, 20, 20, 26, 19, 34, 0, 0, 0, 0, 0, 0, 0
,
0, 35, 18, 82, 82, 82, 82, 19, 34, 0, 0, 0, 0, 0, 0, 0
,
0, 35, 18, 82, 82, 82, 82, 19, 34, 0, 0, 0, 0, 0, 0, 0
,
0, 35, 18, 82, 82, 82, 82, 19, 34, 0, 0, 0, 0, 0, 0, 0
,
0, 35, 18, 82, 82, 82, 82, 19, 34, 0, 0, 0, 0, 0, 0, 0
,
0, 35, 18, 82, 82, 82, 82, 19, 34, 0, 0, 0, 0, 0, 0, 0
,
0, 35, 18, 82, 82, 82, 82, 19, 34, 0, 0, 0, 0, 0, 0, 0
,
0, 35, 18, 82, 82, 82, 82, 19, 34, 0, 0, 0, 0, 0, 0, 0
,
0, 35, 18, 82, 82, 82, 82, 19, 34, 0, 0, 0, 0, 0, 0, 0
,
0, 35, 18, 28, 21, 21, 29, 19, 34, 0, 0, 0, 0, 0, 0, 0
,
0, 35, 18, 19, 30, 31, 18, 19, 34, 0, 0, 0, 0, 0, 0, 0
,
0, 35, 18, 19, 0, 0, 18, 19, 34, 0, 0, 0, 0, 0, 0, 0
,
0, 35, 18, 27, 20, 20, 26, 19, 34, 0, 0, 0, 0, 0, 0, 0
,
0, 35, 18, 82, 82, 82, 82, 19, 34, 0, 0, 0, 0, 0, 0, 0
,
0, 35, 18, 82, 82, 82, 82, 19, 34, 0, 0, 0, 0, 0, 0, 0
,
0, 35, 18, 82, 82, 82, 82, 19, 34, 0, 0, 0, 0, 0, 0, 0
,
0, 35, 18, 82, 82, 82, 82, 19, 34, 0, 0, 0, 0, 0, 0, 0
,
0, 35, 18, 82, 82, 82, 82, 19, 34, 0, 0, 0, 0, 0, 0, 0
,
0, 35, 18, 82, 82, 82, 82, 19, 39, 36, 36, 36, 36, 36, 44, 0
,
0, 35, 18, 82, 82, 82, 82, 27, 20, 20, 20, 20, 20, 24, 34, 0
,
0, 35, 18, 82, 82, 82, 82, 82, 82, 82, 82, 82, 82, 19, 34, 0
,
0, 35, 18, 82, 82, 82, 82, 82, 82, 82, 82, 82, 82, 19, 34, 0
,
0, 35, 18, 82, 82, 82, 82, 82, 82, 82, 82, 82, 82, 19, 34, 0
,
0, 35, 18, 82, 82, 82, 82, 82, 82, 82, 82, 82, 82, 19, 34, 0
,
0, 35, 18, 82, 82, 82, 82, 82, 82, 82, 82, 82, 82, 19, 34, 0
,
0, 35, 18, 82, 82, 82, 82, 82, 82, 82, 82, 82, 82, 19, 34, 0
,
0, 35, 18, 82, 82, 82, 82, 82, 82, 82, 82, 82, 82, 19, 34, 0
,
0, 35, 22, 21, 21, 21, 29, 82, 82, 28, 21, 21, 21, 23, 34, 0
,
0, 42, 33, 33, 33, 38, 18, 82, 82, 19, 37, 33, 33, 33, 41, 0
,
0, 0, 0, 0, 0, 35, 18, 82, 82, 19, 34, 0, 0, 0, 0, 0
,
0, 0, 0, 0, 0, 35, 22, 21, 21, 23, 34, 0, 0, 0, 0, 0
,
0, 0, 0, 0, 0, 42, 33, 33, 33, 33, 41, 0, 0, 0, 0, 0
