0, 0, 0, 0, 0, 0, 0, 0, 0, 0, 0, 0, 0, 0, 0, 0, 
35, 51, 49, 49, 51, 34, 0, 0, 0, 0, 0, 0, 0, 0, 0, 0, 
0, 0, 35, 49, 49, 66, 45, 45, 68, 49, 49, 34,
0, 0, 0, 0, 0, 0, 0, 0, 0, 0, 0, 0, 0, 0, 0, 0, 
35, 50, 48, 48, 50, 34, 0, 0, 0, 0, 0, 0, 0, 0, 0, 0, 
0, 0, 35, 48, 48, 66, 45, 45, 68, 48, 48, 34,
0, 0, 0, 0, 0, 0, 0, 0, 0, 0, 0, 0, 0, 0, 0, 0, 
35, 52, 49, 49, 52, 34, 0, 0, 0, 0, 0, 0, 0, 0, 0, 0, 
0, 0, 35, 49, 49, 67, 25, 24, 69, 49, 49, 34,
0, 0, 0, 0, 0, 0, 0, 0, 0, 0, 0, 0, 0, 0, 0, 0, 
35, 25, 20, 20, 24, 34, 0, 0, 0, 0, 0, 0, 0, 0, 0, 0, 
0, 0, 35, 25, 20, 20, 26, 27, 20, 20, 24, 34,
0, 0, 0, 0, 0, 0, 0, 0, 0, 0, 0, 0, 0, 0, 0, 0, 
35, 18, 58, 61, 19, 34, 0, 0, 0, 0, 0, 0, 0, 0, 0, 0, 
0, 0, 35, 22, 21, 21, 21, 21, 21, 21, 23, 34,
0, 0, 0, 0, 0, 0, 0, 0, 0, 0, 0, 0, 0, 0, 0, 0, 
35, 18, 59, 62, 19, 34, 0, 0, 0, 0, 0, 0, 0, 0, 0, 0, 
0, 0, 35, 30, 32, 32, 32, 32, 32, 32, 31, 34,
43, 36, 36, 36, 36, 36, 36, 36, 36, 36, 36, 36, 36, 36, 36, 36, 
40, 18, 60, 63, 19, 39, 36, 36, 36, 36, 36, 36, 36, 36, 36, 36, 
36, 36, 40, 0, 0, 0, 0, 0, 0, 0, 0, 34,
35, 51, 49, 49, 51, 49, 49, 51, 49, 49, 51, 49, 49, 51, 49, 49, 
51, 18, 81, 81, 19, 49, 51, 49, 49, 51, 49, 49, 51, 49, 49, 51, 
49, 49, 51, 0, 0, 0, 0, 0, 0, 0, 0, 34,
35, 50, 48, 48, 50, 48, 48, 50, 48, 48, 50, 48, 48, 50, 48, 48, 
50, 18, 81, 81, 19, 48, 50, 48, 48, 50, 48, 48, 50, 48, 48, 50, 
48, 48, 50, 0, 0, 0, 0, 0, 0, 0, 0, 34,
35, 52, 49, 49, 52, 49, 49, 52, 49, 49, 52, 49, 49, 52, 49, 49, 
52, 18, 81, 81, 19, 49, 52, 49, 49, 52, 49, 49, 52, 49, 49, 52, 
49, 49, 52, 0, 0, 0, 0, 0, 0, 0, 0, 34,
35, 11, 5, 5, 5, 5, 10, 30, 31, 25, 24, 30, 31, 25, 24, 3, 
3, 18, 81, 81, 19, 30, 32, 32, 31, 25, 24, 3, 3, 30, 32, 32, 
32, 32, 31, 0, 0, 15, 15, 3, 3, 25, 24, 34,
35, 11, 5, 5, 5, 5, 10, 0, 0, 22, 23, 0, 0, 22, 23, 3, 
3, 18, 81, 81, 19, 0, 0, 0, 0, 22, 23, 3, 3, 0, 0, 0, 
0, 0, 0, 0, 0, 14, 14, 3, 3, 22, 23, 34,
35, 3, 3, 25, 20, 20, 24, 0, 0, 30, 31, 0, 0, 3, 3, 25, 
20, 26, 81, 81, 19, 3, 3, 25, 24, 30, 31, 25, 24, 0, 0, 0, 
0, 0, 0, 0, 0, 0, 0, 25, 24, 30, 31, 34,
35, 3, 3, 18, 81, 81, 19, 0, 0, 0, 0, 0, 0, 3, 3, 18, 
81, 81, 28, 21, 23, 3, 3, 22, 23, 0, 0, 18, 19, 0, 0, 0, 
0, 0, 0, 0, 0, 0, 0, 22, 23, 0, 0, 34,
35, 25, 20, 26, 81, 81, 19, 3, 3, 0, 0, 0, 0, 25, 20, 26, 
81, 81, 19, 11, 5, 5, 10, 3, 3, 0, 0, 18, 19, 3, 3, 25, 
24, 0, 0, 0, 0, 3, 3, 30, 31, 25, 24, 34,
35, 18, 81, 81, 81, 81, 19, 3, 3, 0, 0, 0, 0, 22, 21, 21, 
21, 21, 23, 11, 5, 5, 10, 3, 3, 0, 0, 22, 23, 3, 3, 18, 
19, 0, 0, 0, 0, 3, 3, 0, 0, 22, 23, 34,
35, 18, 81, 81, 81, 81, 27, 20, 24, 37, 33, 33, 33, 33, 33, 33, 
33, 33, 33, 33, 33, 33, 33, 33, 33, 33, 33, 33, 33, 33, 38, 18, 
19, 0, 0, 0, 0, 30, 31, 25, 24, 30, 31, 34,
35, 22, 21, 21, 21, 21, 21, 21, 23, 34, 0, 0, 0, 0, 0, 0, 
0, 0, 0, 0, 0, 0, 0, 0, 0, 0, 0, 0, 0, 0, 35, 22, 
23, 0, 0, 0, 0, 0, 0, 22, 23, 0, 0, 34,
35, 30, 32, 32, 32, 32, 32, 32, 31, 34, 0, 0, 0, 0, 0, 0, 
0, 0, 0, 0, 0, 0, 0, 0, 0, 0, 0, 0, 0, 0, 35, 3, 
3, 3, 3, 0, 0, 0, 0, 30, 31, 3, 3, 34,
35, 0, 0, 0, 0, 0, 0, 0, 0, 39, 36, 36, 44, 0, 0, 0, 
0, 0, 0, 0, 0, 0, 0, 0, 0, 0, 0, 0, 0, 0, 35, 3, 
3, 3, 3, 0, 0, 0, 0, 0, 0, 3, 3, 34,
35, 0, 0, 0, 0, 0, 0, 0, 0, 49, 51, 49, 34, 0, 0, 0, 
0, 0, 0, 0, 0, 0, 0, 0, 0, 0, 0, 0, 0, 0, 35, 11, 
5, 5, 5, 5, 5, 5, 10, 0, 0, 30, 31, 34,
35, 0, 0, 0, 0, 0, 0, 0, 0, 48, 50, 48, 34, 0, 0, 0, 
0, 0, 0, 0, 0, 0, 0, 0, 0, 0, 0, 0, 0, 0, 35, 11, 
5, 5, 5, 5, 5, 5, 10, 0, 0, 0, 0, 34,
35, 0, 0, 0, 0, 0, 0, 0, 0, 49, 52, 49, 34, 0, 0, 0, 
0, 0, 0, 0, 0, 0, 0, 0, 0, 0, 0, 0, 0, 0, 42, 33, 
33, 33, 33, 33, 33, 33, 33, 33, 33, 33, 33, 41,
35, 0, 0, 0, 17, 17, 0, 0, 0, 30, 32, 31, 34, 0, 0, 0, 
0, 0, 0, 0, 0, 0, 0, 0, 0, 0, 0, 0, 0, 0, 0, 0, 
0, 0, 0, 0, 0, 0, 0, 0, 0, 0, 0, 0,
35, 0, 0, 0, 17, 17, 0, 0, 0, 0, 0, 0, 34, 0, 0, 0, 
0, 0, 0, 0, 0, 0, 0, 0, 0, 0, 0, 0, 0, 0, 0, 0, 
0, 0, 0, 0, 0, 0, 0, 0, 0, 0, 0, 0,
35, 3, 3, 0, 30, 31, 0, 3, 3, 0, 0, 0, 39, 36, 36, 36, 
36, 36, 36, 36, 36, 36, 36, 36, 36, 36, 36, 36, 36, 36, 36, 36, 
36, 36, 36, 36, 36, 44, 0, 0, 0, 0, 0, 0,
35, 3, 3, 0, 0, 0, 0, 3, 3, 0, 0, 0, 51, 49, 49, 51, 
49, 49, 51, 49, 49, 51, 49, 49, 51, 49, 49, 51, 49, 49, 51, 49, 
49, 51, 49, 49, 51, 34, 0, 0, 0, 0, 0, 0,
35, 30, 31, 25, 24, 0, 0, 30, 31, 25, 20, 24, 50, 48, 48, 50, 
48, 48, 50, 48, 48, 50, 48, 48, 50, 48, 48, 50, 48, 48, 50, 48, 
48, 50, 48, 48, 50, 34, 0, 0, 0, 0, 0, 0,
35, 0, 0, 22, 23, 0, 0, 0, 0, 18, 81, 19, 52, 49, 49, 52, 
49, 49, 52, 49, 49, 52, 49, 49, 52, 49, 49, 52, 49, 49, 52, 49, 
49, 52, 49, 49, 52, 34, 0, 0, 0, 0, 0, 0,
35, 0, 0, 30, 31, 25, 24, 0, 0, 18, 81, 27, 20, 20, 20, 24, 
30, 32, 32, 31, 25, 24, 3, 3, 8, 4, 4, 9, 3, 3, 25, 20, 
20, 20, 20, 20, 24, 34, 0, 0, 0, 0, 0, 0,
35, 0, 0, 0, 0, 22, 23, 0, 0, 18, 81, 81, 81, 81, 81, 19, 
0, 0, 0, 0, 22, 23, 3, 3, 8, 4, 4, 9, 3, 3, 18, 81, 
81, 81, 81, 81, 19, 34, 0, 0, 0, 0, 0, 0,
35, 25, 24, 0, 0, 30, 31, 0, 0, 18, 81, 81, 81, 81, 81, 19, 
3, 3, 25, 24, 30, 31, 25, 20, 20, 20, 20, 24, 3, 3, 18, 81, 
81, 81, 81, 81, 19, 34, 0, 0, 0, 0, 0, 0,
35, 22, 23, 0, 0, 0, 0, 0, 0, 18, 28, 21, 21, 21, 21, 23, 
3, 3, 22, 23, 0, 0, 22, 21, 29, 81, 81, 19, 3, 3, 18, 81, 
81, 81, 81, 81, 19, 34, 0, 0, 0, 0, 0, 0,
35, 30, 31, 3, 3, 0, 0, 0, 0, 18, 19, 3, 3, 11, 5, 5, 
5, 10, 3, 3, 0, 0, 3, 3, 18, 81, 81, 19, 3, 3, 18, 81, 
81, 81, 81, 81, 19, 34, 0, 0, 0, 0, 0, 0,
35, 0, 0, 3, 3, 0, 0, 0, 0, 22, 23, 3, 3, 11, 5, 5, 
5, 10, 3, 3, 0, 0, 3, 3, 22, 21, 21, 23, 3, 3, 22, 29, 
81, 81, 28, 21, 23, 34, 0, 0, 0, 0, 0, 0,
42, 33, 33, 33, 33, 33, 33, 33, 33, 33, 33, 33, 33, 33, 33, 33, 
33, 33, 33, 33, 33, 33, 33, 33, 33, 33, 33, 33, 33, 33, 38, 18, 
81, 81, 19, 37, 33, 41, 0, 0, 0, 0, 0, 0,
0, 0, 0, 0, 0, 0, 0, 0, 0, 0, 0, 0, 0, 0, 0, 0, 
0, 0, 0, 0, 0, 0, 0, 0, 0, 0, 0, 0, 0, 0, 35, 18, 
81, 81, 19, 34, 0, 0, 0, 0, 0, 0, 0, 0,
0, 0, 0, 0, 0, 0, 0, 0, 0, 0, 0, 0, 0, 0, 0, 0, 
0, 0, 0, 0, 0, 0, 0, 0, 0, 0, 0, 0, 0, 0, 35, 22, 
21, 21, 23, 34, 0, 0, 0, 0, 0, 0, 0, 0,
0, 0, 0, 0, 0, 0, 0, 0, 0, 0, 0, 0, 0, 0, 0, 0, 
0, 0, 0, 0, 0, 0, 0, 0, 0, 0, 0, 0, 0, 0, 42, 33, 
33, 33, 33, 41, 0, 0, 0, 0, 0, 0, 0, 0