0, 0, 0, 0, 0, 0, 0, 0, 0, 0, 35, 51, 49, 49, 51, 49, 
49, 51, 49, 49, 51, 49, 49, 51, 49, 34, 0, 0, 0, 0, 0, 0, 
0, 0, 35, 49, 49, 66, 45, 45, 68, 49, 49, 34, 0, 0, 0, 0
,
0, 0, 0, 0, 0, 0, 0, 0, 0, 0, 35, 50, 48, 48, 50, 48, 
48, 50, 48, 48, 50, 48, 48, 50, 48, 34, 0, 0, 0, 0, 0, 0, 
0, 0, 35, 48, 48, 66, 45, 45, 68, 48, 48, 34, 0, 0, 0, 0
,
0, 0, 0, 0, 0, 0, 0, 0, 0, 0, 35, 52, 49, 49, 52, 49, 
49, 52, 49, 49, 52, 49, 49, 52, 49, 34, 0, 0, 0, 0, 0, 0, 
0, 0, 35, 49, 49, 67, 25, 24, 69, 49, 49, 34, 0, 0, 0, 0
,
0, 0, 0, 0, 0, 0, 0, 0, 0, 0, 35, 25, 20, 20, 20, 20, 
24, 3, 3, 25, 20, 20, 20, 20, 24, 34, 0, 0, 0, 0, 0, 0, 
0, 0, 35, 25, 20, 20, 26, 27, 20, 20, 24, 34, 0, 0, 0, 0
,
0, 0, 0, 0, 0, 0, 0, 0, 0, 0, 35, 22, 21, 21, 21, 21, 
23, 3, 3, 18, 81, 81, 81, 81, 19, 34, 0, 0, 0, 0, 0, 0, 
0, 0, 35, 22, 21, 21, 21, 21, 21, 21, 23, 34, 0, 0, 0, 0
,
43, 36, 36, 36, 36, 36, 36, 36, 36, 36, 40, 3, 3, 3, 3, 30, 
31, 25, 20, 26, 81, 81, 81, 81, 19, 34, 0, 0, 0, 0, 0, 0, 
0, 0, 35, 30, 32, 32, 32, 32, 32, 32, 31, 34, 0, 0, 0, 0
,
35, 51, 49, 49, 51, 49, 49, 51, 49, 49, 51, 3, 3, 3, 3, 0, 
0, 22, 21, 29, 81, 81, 81, 81, 19, 34, 0, 0, 0, 0, 0, 0, 
0, 0, 35, 0, 0, 0, 0, 0, 0, 0, 0, 34, 0, 0, 0, 0
,
35, 50, 48, 48, 50, 48, 48, 50, 48, 48, 50, 3, 3, 25, 24, 0, 
0, 30, 31, 18, 81, 81, 81, 81, 19, 34, 0, 0, 0, 0, 0, 0, 
0, 0, 35, 0, 0, 0, 0, 0, 0, 0, 0, 34, 0, 0, 0, 0
,
35, 52, 49, 49, 52, 49, 49, 52, 49, 49, 52, 3, 3, 22, 23, 0, 
0, 0, 0, 18, 81, 81, 81, 81, 19, 34, 0, 0, 0, 0, 0, 0, 
0, 0, 35, 0, 0, 0, 0, 0, 0, 0, 0, 34, 0, 0, 0, 0
,
35, 25, 20, 20, 20, 20, 20, 20, 24, 3, 3, 25, 24, 30, 31, 0, 
0, 0, 0, 18, 28, 21, 21, 21, 23, 34, 0, 0, 0, 0, 0, 0, 
0, 0, 35, 0, 0, 0, 0, 0, 0, 0, 0, 34, 0, 0, 0, 0
,
35, 18, 81, 81, 81, 81, 81, 81, 19, 3, 3, 18, 19, 0, 0, 0, 
0, 0, 0, 18, 19, 2, 2, 2, 2, 34, 0, 0, 0, 0, 0, 0, 
0, 0, 35, 0, 0, 0, 0, 0, 0, 0, 0, 39, 36, 36, 36, 44
,
35, 18, 81, 81, 81, 81, 81, 81, 27, 20, 20, 26, 19, 0, 0, 0, 
0, 0, 0, 18, 27, 20, 20, 20, 24, 34, 0, 0, 0, 0, 0, 0, 
0, 0, 35, 0, 0, 0, 0, 0, 0, 0, 0, 51, 49, 49, 51, 34
,
35, 22, 21, 21, 21, 21, 21, 21, 21, 21, 21, 21, 23, 0, 0, 0, 
0, 0, 0, 22, 21, 21, 29, 81, 19, 34, 0, 0, 0, 0, 0, 0, 
0, 0, 42, 33, 38, 25, 24, 3, 3, 8, 9, 50, 48, 48, 50, 34
,
35, 3, 3, 3, 3, 3, 3, 3, 3, 37, 33, 33, 33, 33, 33, 33, 
33, 33, 38, 2, 2, 2, 18, 81, 19, 34, 0, 0, 0, 0, 0, 0, 
0, 0, 0, 0, 35, 22, 23, 3, 3, 8, 9, 52, 49, 49, 52, 34
,
35, 3, 3, 3, 3, 3, 3, 3, 3, 34, 0, 0, 0, 0, 0, 0, 
0, 0, 35, 25, 20, 20, 26, 81, 19, 34, 0, 0, 0, 0, 0, 0, 
0, 0, 0, 0, 35, 30, 32, 32, 31, 3, 3, 3, 3, 3, 3, 34
,
35, 25, 20, 20, 20, 20, 20, 20, 24, 34, 0, 0, 0, 0, 43, 36, 
36, 36, 40, 18, 28, 21, 21, 21, 23, 39, 36, 36, 36, 36, 36, 36, 
36, 36, 36, 36, 40, 0, 0, 0, 0, 3, 3, 3, 3, 3, 3, 34
,
35, 22, 21, 21, 21, 21, 21, 21, 23, 34, 0, 0, 0, 0, 35, 51, 
49, 49, 51, 18, 19, 2, 2, 2, 2, 51, 49, 49, 51, 49, 49, 51, 
49, 49, 51, 49, 49, 3, 3, 0, 0, 25, 24, 30, 31, 25, 24, 34
,
42, 33, 38, 30, 32, 32, 32, 32, 31, 34, 0, 0, 0, 0, 35, 50, 
48, 48, 50, 18, 27, 20, 20, 20, 24, 50, 48, 48, 50, 48, 48, 50, 
48, 48, 50, 48, 48, 3, 3, 0, 0, 22, 23, 0, 0, 22, 23, 34
,
43, 36, 40, 0, 0, 0, 0, 0, 0, 34, 0, 0, 0, 0, 35, 52, 
49, 49, 52, 18, 81, 81, 28, 21, 23, 52, 49, 49, 52, 49, 49, 52, 
49, 49, 52, 49, 49, 3, 3, 0, 0, 3, 3, 0, 0, 8, 9, 34
,
35, 25, 20, 20, 20, 20, 20, 20, 24, 34, 0, 0, 0, 0, 35, 25, 
20, 20, 20, 26, 81, 81, 19, 30, 31, 3, 3, 25, 20, 20, 20, 20, 
24, 2, 2, 30, 32, 32, 31, 0, 0, 3, 3, 0, 0, 8, 9, 34
,
35, 18, 81, 81, 81, 81, 81, 81, 19, 34, 0, 0, 0, 0, 35, 18, 
28, 21, 21, 21, 21, 21, 23, 0, 0, 3, 3, 18, 81, 81, 81, 81, 
19, 2, 2, 0, 0, 0, 0, 0, 0, 25, 24, 0, 0, 8, 9, 34
,
35, 18, 81, 81, 81, 81, 81, 81, 19, 34, 0, 0, 0, 0, 35, 18, 
19, 30, 32, 32, 32, 32, 31, 0, 0, 3, 3, 18, 81, 81, 81, 81, 
19, 2, 2, 0, 0, 0, 0, 0, 0, 22, 23, 0, 0, 8, 9, 34
,
35, 18, 81, 81, 81, 81, 81, 81, 19, 34, 0, 0, 0, 0, 35, 18, 
19, 0, 0, 0, 0, 0, 0, 0, 0, 3, 3, 18, 81, 81, 81, 81, 
19, 2, 2, 0, 0, 25, 24, 0, 0, 3, 3, 0, 0, 25, 24, 34
,
35, 18, 81, 81, 81, 81, 81, 81, 19, 34, 0, 0, 0, 0, 35, 18, 
19, 0, 0, 0, 0, 0, 0, 0, 0, 3, 3, 18, 81, 81, 81, 81, 
19, 2, 2, 0, 0, 22, 23, 0, 0, 3, 3, 0, 0, 22, 23, 34
,
35, 22, 21, 29, 81, 81, 28, 21, 23, 34, 0, 0, 0, 0, 35, 18, 
19, 11, 5, 5, 5, 5, 5, 5, 10, 3, 3, 18, 81, 81, 81, 81, 
19, 2, 2, 0, 0, 8, 4, 4, 9, 3, 3, 11, 10, 3, 3, 34
,
42, 33, 38, 18, 81, 81, 19, 37, 33, 41, 0, 0, 0, 0, 35, 22, 
23, 11, 5, 5, 5, 5, 5, 5, 10, 3, 3, 22, 21, 21, 21, 21, 
23, 2, 2, 0, 0, 8, 4, 4, 9, 3, 3, 11, 10, 3, 3, 34
,
0, 0, 35, 18, 81, 81, 19, 34, 0, 0, 0, 0, 0, 0, 42, 33, 
33, 33, 33, 33, 33, 33, 33, 33, 33, 33, 33, 33, 33, 33, 33, 33, 
33, 33, 33, 33, 33, 33, 33, 33, 33, 33, 33, 33, 33, 33, 33, 41
,
0, 0, 35, 22, 21, 21, 23, 34, 0, 0, 0, 0, 0, 0, 0, 0, 
0, 0, 0, 0, 0, 0, 0, 0, 0, 0, 0, 0, 0, 0, 0, 0, 
0, 0, 0, 0, 0, 0, 0, 0, 0, 0, 0, 0, 0, 0, 0, 0
,
0, 0, 42, 33, 33, 33, 33, 41, 0, 0, 0, 0, 0, 0, 0, 0, 
0, 0, 0, 0, 0, 0, 0, 0, 0, 0, 0, 0, 0, 0, 0, 0, 
0, 0, 0, 0, 0, 0, 0, 0, 0, 0, 0, 0, 0, 0, 0, 0
