35, 49, 49, 49, 49, 66, 45, 45, 45, 45, 68, 49, 49, 49, 49, 34
,
35, 48, 48, 48, 48, 66, 45, 45, 45, 45, 68, 48, 48, 48, 48, 34
,
35, 49, 49, 49, 49, 67, 17, 17, 17, 17, 69, 49, 49, 49, 49, 34
,
35, 25, 20, 20, 20, 24, 17, 17, 17, 17, 25, 20, 20, 20, 24, 34
,
35, 18, 84, 84, 84, 27, 20, 20, 20, 20, 26, 84, 84, 84, 19, 34
,
35, 18, 84, 84, 84, 84, 84, 84, 84, 84, 84, 84, 84, 84, 19, 34
,
35, 18, 84, 84, 84, 84, 84, 84, 84, 84, 84, 84, 84, 84, 19, 34
,
35, 18, 84, 84, 84, 84, 84, 84, 84, 84, 84, 84, 84, 84, 19, 34
,
35, 18, 84, 84, 84, 84, 84, 84, 84, 84, 84, 84, 84, 84, 19, 34
,
35, 18, 84, 84, 84, 28, 21, 21, 21, 21, 29, 84, 84, 84, 19, 34
,
35, 22, 21, 21, 21, 23, 17, 17, 17, 17, 22, 21, 21, 21, 23, 34
,
42, 33, 33, 33, 33, 38, 17, 17, 17, 17, 37, 33, 33, 33, 33, 41
,
0, 0, 0, 0, 0, 35, 17, 17, 17, 17, 34, 0, 0, 0, 0, 0
,
0, 0, 0, 0, 0, 42, 33, 33, 33, 33, 41, 0, 0, 0, 0, 0
