35, 56, 90, 91, 56, 66, 45, 45, 45, 45, 68, 56, 86, 88, 56, 34
,
35, 56, 92, 85, 56, 66, 45, 45, 45, 45, 68, 56, 87, 89, 56, 34
,
35, 57, 57, 57, 57, 67, 25, 20, 20, 24, 69, 57, 57, 57, 57, 34
,
35, 25, 20, 20, 20, 20, 26, 83, 83, 27, 20, 20, 20, 20, 24, 34
,
35, 18, 83, 83, 83, 83, 83, 83, 83, 83, 83, 83, 83, 83, 19, 34
,
35, 18, 83, 83, 83, 83, 83, 83, 83, 83, 83, 83, 83, 83, 19, 34
,
35, 18, 83, 83, 83, 83, 83, 83, 83, 83, 83, 83, 83, 83, 19, 34
,
35, 18, 83, 83, 83, 83, 83, 83, 83, 83, 83, 83, 83, 83, 19, 34
,
35, 18, 83, 83, 83, 83, 83, 83, 83, 83, 83, 83, 83, 83, 19, 34
,
35, 18, 83, 83, 83, 83, 83, 83, 83, 83, 83, 83, 83, 83, 19, 34
,
35, 18, 83, 83, 83, 83, 83, 83, 83, 83, 83, 83, 83, 83, 19, 34
,
35, 18, 83, 83, 83, 83, 83, 83, 83, 83, 83, 83, 83, 83, 19, 34
,
35, 22, 21, 29, 83, 83, 28, 21, 21, 21, 21, 21, 21, 21, 23, 34
,
35, 3, 3, 18, 83, 83, 19, 3, 3, 3, 3, 3, 3, 3, 3, 34
,
35, 3, 3, 18, 83, 83, 19, 3, 3, 3, 3, 3, 3, 3, 3, 34
,
35, 3, 3, 22, 21, 21, 23, 3, 3, 3, 3, 3, 3, 3, 3, 34
,
35, 2, 2, 2, 2, 2, 2, 2, 2, 2, 2, 2, 2, 2, 2, 34
,
35, 2, 2, 2, 2, 2, 2, 2, 2, 2, 2, 2, 2, 2, 2, 34
,
35, 2, 25, 20, 20, 20, 20, 20, 24, 2, 2, 2, 2, 2, 2, 34
,
35, 2, 22, 21, 21, 21, 21, 21, 23, 2, 2, 25, 24, 2, 2, 34
,
35, 2, 2, 2, 2, 2, 2, 2, 2, 2, 2, 22, 23, 2, 2, 34
,
35, 2, 2, 25, 24, 2, 2, 2, 2, 2, 2, 2, 2, 2, 2, 34
,
35, 2, 2, 22, 23, 2, 2, 2, 2, 2, 2, 2, 2, 2, 2, 34
,
35, 2, 2, 2, 2, 2, 2, 2, 25, 20, 20, 20, 24, 2, 2, 34
,
35, 2, 2, 2, 2, 2, 2, 2, 22, 21, 21, 21, 23, 2, 2, 34
,
35, 2, 2, 2, 2, 2, 2, 2, 2, 2, 2, 2, 2, 2, 2, 34
,
35, 2, 2, 2, 25, 24, 2, 2, 2, 2, 25, 24, 2, 2, 2, 34
,
35, 2, 2, 2, 22, 23, 2, 2, 2, 2, 22, 23, 2, 2, 2, 34
,
35, 2, 2, 2, 2, 2, 2, 2, 2, 2, 2, 2, 2, 2, 2, 34
,
35, 2, 2, 2, 2, 2, 2, 2, 2, 2, 2, 2, 2, 2, 2, 34
,
35, 30, 32, 32, 31, 25, 20, 20, 20, 20, 24, 30, 32, 32, 31, 34
,
35, 0, 0, 0, 0, 22, 21, 21, 21, 21, 23, 0, 0, 0, 0, 34
,
35, 0, 0, 0, 0, 30, 32, 32, 32, 32, 31, 0, 0, 0, 0, 34
,
35, 0, 0, 0, 0, 0, 0, 0, 0, 0, 0, 0, 0, 0, 0, 34
,
35, 0, 0, 0, 0, 0, 0, 0, 0, 0, 0, 0, 0, 0, 0, 34
,
35, 1, 1, 1, 1, 1, 1, 1, 1, 1, 1, 1, 1, 1, 1, 34
,
35, 0, 0, 0, 0, 0, 0, 0, 0, 0, 0, 0, 0, 0, 0, 34
,
35, 0, 0, 0, 0, 0, 0, 0, 0, 0, 0, 0, 0, 0, 0, 34
,
35, 1, 1, 1, 1, 1, 1, 1, 1, 1, 1, 1, 1, 1, 1, 34
,
35, 0, 0, 0, 0, 0, 0, 0, 0, 0, 0, 0, 0, 0, 0, 34
,
35, 0, 0, 0, 0, 0, 0, 0, 0, 0, 0, 0, 0, 0, 0, 34
,
35, 1, 1, 1, 1, 1, 1, 1, 1, 1, 1, 1, 1, 1, 1, 34
,
35, 0, 0, 0, 0, 0, 0, 0, 0, 0, 0, 0, 0, 0, 0, 34
,
35, 0, 0, 0, 0, 0, 0, 0, 0, 0, 0, 0, 0, 0, 0, 34
,
35, 0, 0, 0, 0, 0, 0, 0, 0, 0, 0, 0, 0, 0, 0, 34
,
35, 0, 0, 25, 20, 20, 20, 20, 24, 0, 0, 0, 0, 0, 0, 34
,
35, 0, 0, 18, 83, 83, 83, 83, 19, 0, 0, 0, 0, 0, 0, 34
,
35, 0, 0, 22, 21, 21, 21, 21, 23, 0, 0, 11, 10, 0, 0, 34
,
35, 0, 0, 30, 32, 32, 32, 32, 31, 0, 0, 11, 10, 0, 0, 34
,
35, 0, 0, 0, 0, 0, 0, 0, 0, 0, 0, 64, 65, 0, 0, 34
,
35, 0, 0, 0, 0, 0, 0, 0, 0, 0, 0, 0, 0, 0, 0, 34
,
35, 0, 0, 11, 10, 0, 0, 25, 20, 20, 20, 20, 24, 0, 0, 34
,
35, 0, 0, 11, 10, 0, 0, 22, 21, 21, 21, 21, 23, 0, 0, 34
,
35, 0, 0, 11, 10, 0, 0, 30, 32, 32, 32, 32, 31, 0, 0, 34
,
35, 0, 0, 11, 10, 0, 0, 0, 0, 0, 0, 0, 0, 0, 0, 34
,
35, 0, 0, 64, 65, 0, 0, 0, 0, 0, 0, 0, 0, 0, 0, 34
,
35, 0, 0, 0, 0, 0, 0, 0, 0, 0, 0, 0, 0, 0, 0, 34
,
35, 25, 20, 20, 20, 20, 20, 20, 20, 20, 20, 20, 20, 20, 24, 34
,
35, 18, 83, 83, 83, 83, 83, 83, 83, 83, 83, 83, 83, 83, 19, 34
,
35, 18, 83, 83, 83, 83, 83, 83, 83, 83, 83, 83, 83, 83, 19, 34
,
35, 18, 83, 83, 83, 28, 21, 21, 21, 21, 29, 83, 83, 83, 19, 34
,
35, 18, 83, 83, 83, 19, 30, 32, 32, 31, 18, 83, 83, 83, 19, 34
,
35, 22, 21, 21, 21, 23, 0, 0, 0, 0, 22, 21, 21, 21, 23, 34
,
35, 13, 13, 13, 13, 13, 13, 13, 13, 13, 13, 13, 13, 13, 13, 34
,
35, 6, 6, 6, 12, 12, 6, 6, 6, 6, 12, 12, 6, 6, 6, 34
,
35, 6, 6, 6, 25, 24, 6, 6, 6, 6, 25, 24, 6, 6, 6, 34
,
35, 6, 6, 6, 22, 23, 6, 6, 6, 6, 22, 23, 6, 6, 6, 34
,
35, 6, 6, 6, 13, 13, 6, 6, 6, 6, 13, 13, 6, 6, 6, 34
,
35, 6, 6, 6, 6, 6, 6, 6, 6, 6, 6, 6, 6, 6, 6, 34
,
35, 6, 6, 6, 6, 6, 6, 6, 6, 6, 6, 6, 6, 6, 6, 34
,
35, 6, 6, 6, 6, 6, 6, 6, 6, 6, 6, 6, 6, 6, 6, 34
,
35, 6, 6, 6, 6, 6, 6, 6, 6, 6, 6, 6, 6, 6, 6, 34
,
35, 12, 12, 12, 12, 12, 12, 12, 12, 12, 12, 12, 12, 12, 12, 34
,
35, 0, 0, 0, 0, 0, 0, 0, 0, 0, 0, 0, 0, 0, 0, 34
,
35, 0, 0, 0, 0, 0, 0, 0, 0, 0, 0, 0, 0, 0, 0, 34
,
35, 0, 0, 0, 0, 0, 0, 0, 0, 0, 0, 0, 0, 0, 0, 34
,
35, 0, 0, 0, 0, 0, 0, 0, 0, 0, 0, 0, 0, 0, 0, 34
,
35, 15, 15, 15, 15, 15, 15, 15, 15, 15, 15, 15, 15, 15, 15, 34
,
35, 7, 7, 7, 7, 7, 7, 7, 7, 14, 14, 7, 7, 7, 7, 34
,
35, 7, 7, 14, 14, 7, 7, 7, 7, 25, 24, 7, 7, 7, 7, 34
,
35, 7, 7, 25, 24, 7, 7, 7, 7, 22, 23, 7, 7, 7, 7, 34
,
35, 7, 7, 22, 23, 7, 7, 7, 7, 15, 15, 7, 7, 7, 7, 34
,
35, 7, 7, 15, 15, 7, 7, 7, 7, 7, 7, 7, 7, 7, 7, 34
,
35, 7, 7, 7, 7, 7, 7, 7, 7, 7, 7, 14, 14, 7, 7, 34
,
35, 7, 7, 7, 7, 14, 14, 7, 7, 7, 7, 25, 24, 7, 7, 34
,
35, 7, 7, 7, 7, 25, 24, 7, 7, 7, 7, 22, 23, 7, 7, 34
,
35, 7, 7, 7, 7, 22, 23, 7, 7, 7, 7, 15, 15, 7, 7, 34
,
35, 7, 7, 7, 7, 15, 15, 7, 7, 7, 7, 7, 7, 7, 7, 34
,
35, 14, 14, 14, 14, 14, 14, 14, 14, 14, 14, 14, 14, 14, 14, 34
,
35, 0, 0, 0, 0, 0, 0, 0, 0, 0, 0, 0, 0, 0, 0, 34
,
35, 0, 0, 0, 0, 0, 0, 0, 0, 0, 0, 0, 0, 0, 0, 34
,
35, 25, 20, 20, 20, 20, 20, 20, 20, 20, 20, 20, 20, 20, 24, 34
,
35, 18, 83, 83, 83, 83, 83, 83, 83, 83, 83, 83, 83, 83, 19, 34
,
35, 18, 83, 83, 83, 83, 83, 83, 83, 83, 83, 83, 83, 83, 19, 34
,
35, 18, 83, 83, 83, 83, 83, 83, 83, 83, 83, 83, 83, 83, 19, 34
,
35, 22, 21, 21, 21, 21, 21, 21, 21, 21, 21, 21, 21, 21, 23, 34
,
35, 30, 32, 32, 32, 32, 32, 32, 32, 32, 32, 32, 32, 32, 31, 34
,
35, 0, 0, 1, 0, 0, 1, 0, 0, 0, 0, 1, 0, 0, 0, 34
,
35, 0, 0, 0, 0, 0, 0, 0, 1, 0, 0, 0, 0, 8, 9, 34
,
35, 11, 10, 0, 11, 10, 0, 0, 0, 0, 11, 10, 0, 8, 9, 34
,
35, 11, 10, 0, 11, 10, 0, 8, 9, 0, 11, 10, 0, 8, 9, 34
,
35, 11, 10, 0, 64, 65, 0, 8, 9, 0, 64, 65, 0, 8, 9, 34
,
35, 11, 10, 0, 0, 1, 0, 64, 65, 0, 0, 0, 0, 64, 65, 34
,
35, 64, 65, 0, 0, 0, 0, 0, 0, 0, 1, 0, 0, 0, 0, 34
,
35, 0, 0, 0, 0, 0, 0, 1, 0, 0, 0, 0, 0, 1, 0, 34
,
35, 25, 20, 20, 20, 20, 20, 20, 20, 20, 20, 20, 20, 20, 24, 34
,
35, 18, 83, 83, 83, 83, 83, 83, 83, 83, 83, 83, 83, 83, 19, 34
,
35, 22, 21, 21, 21, 21, 21, 29, 83, 28, 21, 21, 21, 21, 23, 34
,
42, 33, 33, 33, 33, 33, 38, 18, 83, 19, 37, 33, 33, 33, 33, 41
,
0, 0, 0, 0, 0, 0, 35, 18, 83, 19, 34, 0, 0, 0, 0, 0
,
0, 0, 0, 0, 0, 0, 35, 22, 21, 23, 34, 0, 0, 0, 0, 0
,
0, 0, 0, 0, 0, 0, 42, 33, 33, 33, 41, 0, 0, 0, 0, 0
