18, 18, 18, 18, 18, 22, 24, 15, 15, 28, 26, 18, 18, 18, 18, 18
,
18, 18, 18, 18, 18, 22, 24, 15, 15, 28, 26, 18, 18, 18, 18, 18
,
18, 18, 18, 18, 18, 23, 25, 1, 1, 29, 27, 18, 18, 18, 18, 18
,
19, 20, 2, 1, 1, 1, 1, 1, 1, 1, 1, 1, 1, 3, 19, 20
,
21, 21, 2, 1, 1, 1, 1, 1, 1, 1, 1, 1, 1, 3, 21, 21
,
19, 20, 2, 1, 1, 1, 1, 1, 1, 1, 1, 1, 1, 3, 19, 20
,
21, 21, 2, 1, 1, 1, 1, 1, 1, 1, 1, 1, 1, 3, 21, 21
,
19, 20, 2, 1, 1, 1, 1, 1, 1, 1, 1, 1, 1, 3, 19, 20
,
21, 21, 2, 1, 1, 1, 1, 1, 1, 1, 1, 1, 1, 3, 21, 21
,
19, 20, 2, 1, 1, 1, 1, 1, 1, 1, 1, 1, 1, 3, 19, 20
,
21, 21, 2, 1, 1, 1, 1, 1, 1, 1, 1, 1, 1, 3, 21, 21
,
19, 20, 2, 1, 1, 1, 1, 1, 1, 1, 1, 1, 1, 3, 19, 20
,
21, 21, 2, 1, 1, 1, 1, 1, 1, 1, 1, 1, 1, 3, 21, 21
,
19, 20, 6, 5, 5, 5, 13, 1, 1, 12, 5, 5, 5, 7, 19, 20
,
20, 19, 33, 31, 33, 32, 2, 1, 1, 3, 33, 32, 31, 32, 20, 19
,
19, 20, 19, 30, 19, 20, 2, 1, 1, 3, 19, 20, 30, 20, 19, 20
,
20, 19, 20, 30, 20, 19, 2, 1, 1, 3, 20, 19, 30, 19, 20, 19
,
19, 20, 19, 30, 19, 20, 2, 1, 1, 3, 19, 20, 30, 20, 19, 20
,
20, 19, 20, 30, 20, 19, 2, 1, 1, 3, 20, 19, 30, 19, 20, 19
,
19, 20, 19, 30, 19, 20, 2, 1, 1, 3, 19, 20, 30, 20, 19, 20
,
20, 19, 20, 30, 20, 19, 2, 1, 1, 3, 20, 19, 30, 19, 20, 19
,
19, 20, 9, 4, 4, 4, 10, 1, 1, 11, 4, 4, 4, 8, 19, 20
,
21, 21, 2, 1, 1, 1, 1, 1, 1, 1, 1, 1, 1, 3, 21, 21
,
19, 20, 2, 16, 1, 1, 1, 1, 1, 1, 1, 1, 16, 3, 19, 20
,
21, 21, 2, 17, 1, 1, 1, 1, 1, 1, 1, 1, 17, 3, 21, 21
,
19, 20, 2, 1, 1, 1, 1, 1, 1, 1, 1, 1, 1, 3, 19, 20
,
21, 21, 2, 1, 1, 1, 1, 1, 1, 1, 1, 1, 1, 3, 21, 21
,
19, 20, 2, 16, 1, 1, 1, 1, 1, 1, 1, 1, 16, 3, 19, 20
,
21, 21, 2, 17, 1, 1, 1, 1, 1, 1, 1, 1, 17, 3, 21, 21
,
19, 20, 2, 1, 1, 1, 1, 1, 1, 1, 1, 1, 1, 3, 19, 20
,
21, 21, 2, 1, 1, 1, 1, 1, 1, 1, 1, 1, 1, 3, 21, 21
,
19, 20, 2, 16, 1, 1, 1, 1, 1, 1, 1, 1, 16, 3, 19, 20
,
21, 21, 2, 17, 1, 1, 1, 1, 1, 1, 1, 1, 17, 3, 21, 21
,
19, 20, 2, 1, 1, 1, 1, 1, 1, 1, 1, 1, 1, 3, 19, 20
,
20, 19, 6, 5, 5, 5, 5, 5, 5, 5, 5, 5, 5, 7, 20, 19
,
19, 20, 32, 31, 32, 32, 33, 32, 33, 33, 32, 33, 31, 32, 19, 20
,
20, 19, 19, 30, 19, 19, 20, 19, 20, 20, 19, 20, 30, 20, 20, 19
,
19, 20, 20, 30, 20, 20, 19, 20, 19, 19, 20, 19, 30, 19, 19, 20
,
20, 19, 19, 30, 19, 19, 20, 19, 20, 20, 19, 20, 30, 20, 20, 19
,
19, 20, 20, 30, 20, 20, 19, 20, 19, 19, 20, 19, 30, 19, 19, 20
,
20, 19, 20, 30, 20, 20, 19, 20, 19, 19, 20, 19, 30, 19, 20, 19
,
19, 20, 19, 30, 19, 19, 20, 19, 20, 20, 19, 20, 30, 20, 19, 20
,
20, 19, 20, 30, 20, 20, 19, 20, 19, 19, 20, 19, 30, 19, 20, 19
,
19, 20, 9, 4, 4, 4, 4, 4, 4, 4, 4, 4, 4, 8, 19, 20
,
21, 21, 2, 1, 1, 1, 1, 1, 1, 1, 1, 1, 1, 3, 21, 21
,
19, 20, 2, 1, 1, 1, 1, 1, 1, 1, 1, 1, 1, 3, 19, 20
,
21, 21, 2, 16, 1, 1, 1, 1, 1, 1, 1, 1, 16, 3, 21, 21
,
19, 20, 2, 17, 1, 1, 1, 1, 1, 1, 1, 1, 17, 3, 19, 20
,
21, 21, 2, 1, 1, 1, 1, 1, 1, 1, 1, 1, 1, 3, 21, 21
,
19, 20, 2, 1, 1, 1, 1, 1, 1, 1, 1, 1, 1, 3, 19, 20
,
21, 21, 2, 1, 1, 1, 1, 1, 1, 1, 1, 1, 1, 3, 21, 21
,
19, 20, 2, 1, 1, 1, 1, 1, 1, 1, 1, 1, 1, 3, 19, 20
,
21, 21, 2, 16, 1, 1, 1, 1, 1, 1, 1, 1, 16, 3, 21, 21
,
19, 20, 2, 17, 1, 1, 1, 1, 1, 1, 1, 1, 17, 3, 19, 20
,
21, 21, 2, 1, 1, 1, 1, 1, 1, 1, 1, 1, 1, 3, 21, 21
,
19, 20, 2, 1, 1, 1, 1, 1, 1, 1, 1, 1, 1, 3, 19, 20
,
20, 19, 6, 5, 5, 5, 5, 5, 5, 5, 13, 1, 12, 7, 20, 19
,
19, 20, 32, 33, 31, 33, 31, 33, 31, 33, 2, 1, 3, 32, 19, 20
,
20, 19, 20, 19, 30, 20, 30, 20, 30, 20, 2, 1, 3, 19, 20, 19
,
19, 20, 19, 20, 30, 19, 30, 19, 30, 19, 2, 1, 3, 20, 19, 20
,
20, 19, 20, 19, 30, 20, 30, 20, 30, 20, 2, 1, 3, 19, 20, 19
,
19, 20, 19, 9, 4, 4, 4, 4, 4, 4, 10, 1, 3, 20, 19, 20
,
20, 19, 20, 2, 1, 12, 5, 5, 5, 5, 5, 5, 7, 19, 20, 19
,
19, 20, 19, 2, 1, 3, 32, 31, 32, 31, 32, 31, 32, 20, 19, 20
,
20, 19, 20, 2, 1, 3, 20, 30, 20, 30, 20, 30, 20, 19, 20, 19
,
19, 20, 19, 2, 1, 3, 19, 30, 19, 30, 19, 30, 19, 20, 19, 20
,
20, 19, 20, 2, 1, 11, 4, 4, 4, 4, 4, 4, 8, 19, 20, 19
,
19, 20, 19, 2, 1, 1, 1, 1, 1, 1, 1, 1, 3, 20, 19, 20
,
20, 19, 20, 2, 1, 1, 1, 1, 1, 1, 1, 1, 3, 19, 20, 19
,
21, 21, 21, 2, 1, 1, 1, 1, 1, 1, 1, 1, 3, 21, 21, 21
,
20, 19, 20, 2, 1, 1, 1, 1, 1, 1, 1, 1, 3, 19, 20, 19
,
21, 21, 21, 2, 1, 1, 1, 1, 1, 1, 1, 1, 3, 21, 21, 21
,
20, 19, 20, 2, 1, 1, 1, 1, 1, 1, 1, 1, 3, 19, 20, 19
,
21, 21, 21, 2, 16, 1, 1, 1, 1, 1, 1, 16, 3, 21, 21, 21
,
20, 19, 20, 2, 17, 1, 1, 1, 1, 1, 1, 17, 3, 20, 19, 20
,
21, 21, 21, 2, 1, 1, 1, 1, 1, 1, 1, 1, 3, 21, 21, 21
,
20, 19, 20, 2, 1, 1, 1, 1, 1, 1, 1, 1, 3, 19, 20, 19
,
21, 21, 21, 2, 1, 1, 1, 1, 1, 1, 1, 1, 3, 21, 21, 21
,
20, 19, 20, 2, 16, 1, 1, 1, 1, 1, 1, 16, 3, 19, 20, 19
,
21, 21, 21, 2, 17, 1, 1, 1, 1, 1, 1, 17, 3, 21, 21, 21
,
20, 19, 20, 2, 1, 1, 1, 1, 1, 1, 1, 1, 3, 19, 20, 19
,
21, 21, 21, 2, 1, 1, 1, 1, 1, 1, 1, 1, 3, 21, 21, 21
,
20, 19, 20, 2, 1, 1, 1, 1, 1, 1, 1, 1, 3, 19, 20, 19
,
21, 21, 21, 2, 16, 1, 1, 1, 1, 1, 1, 16, 3, 21, 21, 21
,
20, 19, 20, 2, 17, 1, 1, 1, 1, 1, 1, 17, 3, 19, 20, 19
,
21, 21, 21, 2, 1, 1, 1, 1, 1, 1, 1, 1, 3, 21, 21, 21
,
20, 19, 20, 2, 1, 1, 1, 1, 1, 1, 1, 1, 3, 19, 20, 19
,
21, 21, 21, 2, 1, 1, 1, 1, 1, 1, 1, 1, 3, 21, 21, 21
,
20, 19, 20, 2, 16, 1, 1, 1, 1, 1, 1, 16, 3, 19, 20, 19
,
21, 21, 21, 2, 17, 1, 1, 1, 1, 1, 1, 17, 3, 21, 21, 21
,
20, 19, 20, 2, 1, 1, 1, 1, 1, 1, 1, 1, 3, 19, 20, 19
,
21, 21, 21, 2, 1, 1, 1, 1, 1, 1, 1, 1, 3, 21, 21, 21
,
20, 19, 20, 2, 1, 1, 1, 1, 1, 1, 1, 1, 3, 19, 20, 19
,
19, 20, 19, 2, 1, 1, 1, 1, 1, 1, 1, 1, 3, 20, 19, 20
,
14, 14, 14, 14, 14, 14, 14, 14, 14, 14, 14, 14, 14, 14, 14, 14
,
0, 0, 0, 0, 0, 0, 0, 0, 0, 0, 0, 0, 0, 0, 0, 0
