35, 56, 53, 56, 56, 66, 45, 45, 45, 45, 68, 56, 56, 53, 56, 34
,
35, 56, 54, 56, 56, 66, 45, 45, 45, 45, 68, 56, 56, 54, 56, 34
,
35, 57, 55, 57, 57, 67, 25, 20, 20, 24, 69, 57, 57, 55, 57, 34
,
35, 25, 20, 20, 20, 20, 26, 16, 16, 27, 20, 20, 20, 20, 24, 34
,
35, 18, 16, 16, 16, 16, 16, 16, 16, 16, 16, 16, 16, 16, 19, 34
,
35, 18, 16, 16, 16, 16, 16, 16, 16, 16, 16, 16, 16, 16, 19, 34
,
35, 18, 16, 16, 16, 16, 16, 16, 16, 16, 16, 16, 16, 16, 19, 34
,
35, 18, 16, 16, 16, 16, 16, 16, 16, 16, 16, 16, 16, 16, 19, 34
,
35, 18, 16, 16, 16, 16, 16, 16, 16, 16, 16, 16, 16, 16, 19, 34
,
35, 18, 16, 16, 16, 16, 16, 16, 16, 16, 16, 16, 16, 16, 19, 34
,
35, 22, 21, 21, 29, 16, 16, 16, 16, 16, 16, 28, 21, 21, 23, 34
,
42, 33, 33, 38, 22, 21, 21, 21, 21, 21, 21, 23, 37, 33, 33, 41
,
0, 0, 0, 35, 13, 13, 13, 13, 13, 13, 13, 13, 34, 0, 0, 0
,
0, 0, 0, 35, 12, 12, 12, 12, 12, 12, 12, 12, 34, 0, 0, 0
,
0, 0, 0, 35, 25, 20, 20, 20, 20, 20, 20, 24, 34, 0, 0, 0
,
0, 0, 0, 35, 22, 21, 21, 21, 21, 21, 21, 23, 34, 0, 0, 0
,
0, 0, 0, 35, 15, 15, 15, 15, 15, 15, 15, 15, 34, 0, 0, 0
,
0, 0, 0, 35, 14, 14, 14, 14, 14, 14, 14, 14, 39, 44, 0, 0
,
0, 0, 0, 35, 25, 20, 20, 20, 20, 20, 20, 20, 24, 34, 0, 0
,
0, 0, 0, 35, 22, 21, 21, 21, 21, 21, 21, 21, 23, 34, 0, 0
,
0, 0, 0, 35, 13, 13, 13, 13, 13, 13, 13, 13, 13, 34, 0, 0
,
0, 0, 43, 40, 12, 12, 12, 12, 12, 12, 12, 12, 12, 34, 0, 0
,
0, 0, 35, 25, 20, 20, 20, 20, 20, 20, 20, 20, 24, 34, 0, 0
,
0, 0, 35, 18, 16, 16, 16, 16, 16, 16, 16, 16, 19, 34, 0, 0
,
0, 0, 35, 18, 16, 16, 16, 16, 16, 16, 16, 16, 19, 34, 0, 0
,
0, 0, 35, 18, 16, 16, 16, 16, 16, 16, 16, 16, 19, 34, 0, 0
,
0, 0, 35, 18, 16, 16, 16, 16, 16, 16, 16, 16, 19, 34, 0, 0
,
0, 0, 35, 18, 16, 46, 16, 16, 16, 16, 46, 16, 19, 34, 0, 0
,
0, 0, 35, 18, 16, 47, 16, 16, 16, 16, 47, 16, 19, 34, 0, 0
,
0, 0, 35, 18, 16, 16, 16, 16, 16, 16, 16, 16, 19, 34, 0, 0
,
0, 0, 35, 18, 16, 16, 16, 16, 16, 16, 16, 16, 19, 34, 0, 0
,
0, 0, 35, 18, 16, 16, 16, 16, 16, 16, 16, 16, 19, 34, 0, 0
,
0, 0, 35, 22, 29, 16, 16, 16, 16, 16, 16, 28, 23, 34, 0, 0
,
0, 0, 42, 38, 22, 21, 21, 21, 21, 21, 21, 23, 37, 41, 0, 0
,
0, 0, 0, 35, 11, 5, 5, 10, 2, 2, 2, 2, 34, 0, 0, 0
,
0, 0, 0, 35, 11, 5, 5, 10, 2, 2, 2, 2, 34, 0, 0, 0
,
0, 0, 0, 35, 11, 5, 5, 10, 2, 2, 2, 2, 34, 0, 0, 0
,
0, 0, 0, 35, 11, 5, 5, 10, 2, 2, 2, 2, 34, 0, 0, 0
,
0, 0, 0, 35, 11, 5, 5, 10, 2, 2, 2, 2, 34, 0, 0, 0
,
0, 0, 43, 40, 25, 20, 20, 20, 20, 20, 20, 24, 39, 44, 0, 0
,
0, 0, 35, 25, 26, 16, 16, 16, 16, 16, 16, 27, 24, 34, 0, 0
,
0, 0, 35, 18, 16, 16, 16, 16, 16, 16, 16, 16, 19, 34, 0, 0
,
0, 0, 35, 22, 29, 16, 16, 16, 16, 16, 16, 28, 23, 34, 0, 0
,
0, 0, 42, 38, 22, 21, 21, 21, 21, 21, 21, 23, 37, 41, 0, 0
,
0, 0, 0, 35, 2, 2, 2, 2, 8, 4, 4, 9, 34, 0, 0, 0
,
0, 0, 0, 35, 2, 2, 2, 2, 8, 4, 4, 9, 34, 0, 0, 0
,
0, 0, 0, 35, 2, 2, 2, 2, 8, 4, 4, 9, 34, 0, 0, 0
,
0, 0, 0, 35, 2, 2, 2, 2, 8, 4, 4, 9, 34, 0, 0, 0
,
0, 0, 0, 35, 2, 2, 2, 2, 8, 4, 4, 9, 34, 0, 0, 0
,
0, 0, 0, 35, 2, 2, 2, 2, 8, 4, 4, 9, 34, 0, 0, 0
,
0, 0, 43, 40, 25, 20, 20, 20, 20, 20, 20, 24, 39, 44, 0, 0
,
0, 0, 35, 25, 26, 16, 16, 16, 16, 16, 16, 27, 24, 34, 0, 0
,
0, 0, 35, 18, 16, 16, 16, 16, 16, 16, 16, 16, 19, 34, 0, 0
,
0, 0, 35, 22, 21, 21, 29, 16, 16, 28, 21, 21, 23, 34, 0, 0
,
0, 0, 42, 33, 33, 38, 18, 16, 16, 19, 37, 33, 33, 41, 0, 0
,
0, 0, 0, 0, 0, 35, 18, 16, 16, 19, 34, 0, 0, 0, 0, 0
,
0, 0, 0, 0, 0, 35, 22, 21, 21, 23, 34, 0, 0, 0, 0, 0
,
0, 0, 0, 0, 0, 42, 33, 33, 33, 33, 41, 0, 0, 0, 0, 0
